type octile
height 12
width 10
map
..........
..........
..........
..........
@@@.......
..........
..........
..........
@@@@@@....
..........
..........
..........
