type octile
height 10
width 10
map
@@@@@@@@.@
@........@
@........@
@........@
@....@...@
@....@...@
@....@...@
@....@....
.....@....
@@@@@@@..@

