type octile
height 5
width 11
map
.....@.....
.....@.....
.....@.....
.....@.....
...........
